00000000000000000000
00000000000000000000
00000000000000000000
00000000000000000000
00000002000000000000
00000032040003400003
00000112110111111011
00000002000000000000
00000002000000000000
00000002003400000000
00003002011100000000
00011112000000004000
00000002000000011000
00000002000001100000
00020002003110000000
00320402011000040300
00121112100000111110
00020002000000000000
00020002000000000000
00020002000200002000
03020402000203402030
01111112111211112110
00000002000200002000
00000002000200002000
00000002000200002000
00403002000204002000
11111111111111111111

Swan1=06,17
Swan2=09,22
Swan3=0
Swan4=0
StartX=70
StartY=200