00000000000000000000
00000000000000000000
00000000000000000000
00030000000000000300
00000000002000000000
00000000052000000000
00010313112113130100
00000000002000000000
00000000002000000000
00002000002000002000
00002000002000002000
00012110311130112100
00002000000000002000
00002000000000002000
00002000002000002000
00002000052000002000
00111130112110311110
00000000002000000000
00000000002000000000
00020000002000000200
00020000002000000250
00121301111111031210
00020000000000000200
00020000000000000200
00020000000000000200
64424446444444444244
11111111111111111111